$ # # # # # # # # # # # # # # # # # # # # # # # # # # # # #
$ . . . ! . . . . . . . . . . . . ! . . . . . . . . . . . #
$ . . . ! . . . . . . . . . . . . ! . . . . . . . . . . . #
$ . . . ! . . . . . . . . . . . . ! . . . . . . . . . . . #
$ . . . ! . . . . . ! . . . . . . ! . . . . . . . . . . . #
$ . . . ! . . . . . ! . . . . . . ! . . . . . . . . . . . #
$ . . . ! . . . . . ! . . . . . . ! . . . . . . . . . . . #
$ . . . ! . . . . . ! . . . . . . ! . . . . . . . . . . . #
$ . . . . . . . . . . . . . . . . . . . . . . . . . . . . #
$ . . . . . S . . . . . . . . . . . . . . . . . . . . . . #
$ . . . . . . . . . . . . . . . . . . . . . . . . . . . . #
$ . . . . . . . . . . . . . . . . . . . . . . . . . . . . #
$ . . . . . ! . . . . . . . . . . . . . . . . . . . . . . #
$ . . . . . ! . . . . . . . . . . . . . . . . . . . . . . #
$ . . . . . ! . . . . . . . . . . . . . . . . . . . . . . #
$ . . . . . ! . . . . . . . . . . . . . . . . . . . . . . #
# # # # # # # # # # # # # # # # # # # # # # # # # # # # # #