$ # # # # . # # # # # # # # # # # # # # # # # # # # # # # #
$ . . . . . . . . . . . . . . . . . . . . . . . . . . . . #
$ . . . . . . . . . . . . . . . . . . . . . . . . . # . . #
$ . . . . . . . . . . . . . . . . . . . . . . . . @ # . . #
$ . . . . . . . . . . . . . . . . . . . . . . . . . . . . #
$ . . . # # # # . . . . . . . . . . . . . . . . . . . . . #
$ . . . # . . . . . . . . . . . . . . . . . . . A . . . . #
$ . . . # . . . . . . . . . . . . . . # . . . . . . . . . #
$ . . . . . . . . . . . . . . . . . . . . . . . . . . . . #
$ . . . . . . . . . . . . . . . . . . . . . . . . . . . . #
$ . . . . . . . . . . . . . . . . . . . . . . . A . . . . #
$ . . . . . . . . . . . . . . . . . . . . . . . . . . . . #
$ . . . . . . . . @ # . . . . . . . . . . . . . . . . . . #
$ . . . . . . . . . . . . . . . . . . . . . . A . . . . . #
$ . . . . . . . . . . . . . . . . . . . . . . . . . . . . #
$ . . . . . . . . . . . . . . . . . . . . . . . . . . . . #
# # # # # # # # # # # # # # # # # # # # # # # # # # # # # #