$ # # # # # # # # # # # # # # # # # # # # # # # # # # # # #
$ . . . # . . . . . . . . . . . . . . . . . . . . . . . . #
$ . . . # . . . . . . . . . . . . . . . . . . . . . # . . #
$ . . . # . . . . . . . . . . . . . . . . . . . . . # . . #
$ . . . # . . . . . . . . . . . . . . . . . . . . . . . . #
$ . . . # # # # . . . . . . . . . . . . . . . . . @ . . . #
$ . . . # . . . . . . . . . . . . . . . . . . . A . . . . #
$ . . . # . . . . . . . . . . . . . . # . . . . . . . . . #
$ . . . . . . . . . . . . . . . . . . . . . . . . . . . . #
$ . . . . . . . . . . @ . . . . . . . . . . . . . . . . . #
$ . . . . . . . . . . . . . . . . . . . . . . . A . . . . #
$ . . . . . . . . . . . . . @ . . . . . . . . . . . . . . #
$ . . . . . # . # # # . . . . . . . . . . . . . . . . . . #
$ . . . . . # . . . . . . . . . . . . . . . . A . . . . . #
$ . . . . . # . . @ . . . . . . . . . . . . . . . . . . . #
$ . . . . . # . . . . . . . . . . . . . . . . . . . . . . #
# # # # # # # # # # # # # # # # # # # # # # # # # # # # # #