$ # # # # # # # # # # # # # # # # # # # # # # # # # # # # #
$ . . . ! . . . . . . . . . . . . . . . . . . . . . . . . #
$ . . . ! . . . . . . . . . . . . . . . . . . . . . . . . #
$ . . . ! . . . . . . . . . . . . . . . . . . . . . . . . #
$ . . . ! . . . . . . . . . . . . . . . . . . . . . . . . #
$ . . . ! ! ! ! . . . . . . . . . . . . . . . . . @ . . . #
$ . . . ! . . . . . . . . . . . . . . . . . . . A . . . . #
$ . . . ! . . . . . . . . . . . . . . ! . . . . . . . . . #
$ . . . . . . . . . . . . . . . . . . . . . . . . . . . . #
$ . . . . . . . . . . @ . . . . . . . . . . . . . . . . . #
$ . . . . . . . . . . . . . . . . . . . . . . . A . . . . #
$ . . . . . . . . . . . . . @ . . . . . . . . . . . . . . #
$ . . . . . ! ! ! ! ! . . . . . . . . . . . . . . . . . . #
$ . . . . . ! . . . . . . . . . . . . . . . . A . . . . . #
$ . . . . . ! . . @ . . . . . . . . . . . . . . . . . . . #
$ . . . . . ! . . . . . . . . . . . . . . . . . . S . . . #
# # # # # # # # # # # # # # # # # # # # # # # # # # # # # #